DISTRITO,COD_DIST,UGM,TOTAL,HOMBRES,MUJERES,EXPOSICION_NORMALIZACION_BASE_100,CATEGORIA_EXPOSICION
Liberia           ,50101,38541,65,28,37,7.82608695652174,Medio
Liberia           ,50101,38555,61,22,39,7.329192546583851,Medio
Liberia           ,50101,38563,73,31,42,8.819875776397515,Medio
Liberia           ,50101,38575,44,16,28,5.217391304347826,Bajo-medio
Liberia           ,50101,38584,182,90,92,22.36024844720497,Alto
Liberia           ,50101,38589,16,8,8,1.7391304347826086,Bajo
Liberia           ,50101,38592,69,33,36,8.322981366459627,Medio
Liberia           ,50101,38595,202,107,95,24.84472049689441,Alto
Liberia           ,50101,38606,106,50,56,12.919254658385093,Alto-medio
Liberia           ,50101,38611,30,15,15,3.4782608695652173,Bajo-medio
Liberia           ,50101,38626,90,46,44,10.93167701863354,Medio
Liberia           ,50101,38627,79,33,46,9.565217391304348,Medio
Liberia           ,50101,38639,13,4,9,1.3664596273291925,Bajo
Liberia           ,50101,38662,129,57,72,15.77639751552795,Alto-medio
Liberia           ,50101,38668,27,12,15,3.1055900621118013,Bajo-medio
Liberia           ,50101,38678,50,24,26,5.962732919254658,Bajo-medio
Liberia           ,50101,38702,30,18,12,3.4782608695652173,Bajo-medio
Liberia           ,50101,38726,22,9,13,2.484472049689441,Bajo
Liberia           ,50101,38730,116,45,71,14.161490683229813,Alto-medio
Liberia           ,50101,38740,40,22,18,4.720496894409938,Bajo-medio
Liberia           ,50101,38750,44,22,22,5.217391304347826,Bajo-medio
Liberia           ,50101,38758,27,12,15,3.1055900621118013,Bajo-medio
Liberia           ,50101,38796,114,49,65,13.91304347826087,Alto-medio
Liberia           ,50101,38797,27,12,15,3.1055900621118013,Bajo-medio
Liberia           ,50101,38817,118,61,57,14.409937888198757,Alto-medio
Liberia           ,50101,38831,130,67,63,15.900621118012422,Alto-medio
Liberia           ,50101,38839,65,27,38,7.82608695652174,Medio
Liberia           ,50101,38840,199,90,109,24.472049689440993,Alto
Liberia           ,50101,38844,218,100,118,26.83229813664596,Alto
Liberia           ,50101,38854,87,44,43,10.559006211180124,Medio
Liberia           ,50101,38856,35,19,16,4.099378881987578,Bajo-medio
Liberia           ,50101,38858,186,104,82,22.857142857142858,Alto
Liberia           ,50101,38859,12,6,6,1.2422360248447204,Bajo
Liberia           ,50101,38867,105,59,46,12.79503105590062,Alto-medio
Liberia           ,50101,38876,42,19,23,4.968944099378882,Bajo-medio
Liberia           ,50101,38878,133,71,62,16.273291925465838,Alto-medio
Liberia           ,50101,38879,79,35,44,9.565217391304348,Medio
Liberia           ,50101,38885,46,11,35,5.46583850931677,Bajo-medio
Liberia           ,50101,38886,95,47,48,11.5527950310559,Medio
Liberia           ,50101,38893,83,36,47,10.062111801242237,Medio
Liberia           ,50101,38901,42,23,19,4.968944099378882,Bajo-medio
Liberia           ,50101,38903,45,18,27,5.341614906832298,Bajo-medio
Liberia           ,50101,38911,90,43,47,10.93167701863354,Medio
Liberia           ,50101,38929,91,52,39,11.055900621118013,Medio
Liberia           ,50101,38933,110,52,58,13.41614906832298,Alto-medio
Liberia           ,50101,38934,25,17,8,2.857142857142857,Bajo-medio
Liberia           ,50101,38935,53,25,28,6.3354037267080745,Bajo-medio
Liberia           ,50101,38943,52,28,24,6.211180124223603,Bajo-medio
Liberia           ,50101,38949,60,32,28,7.204968944099378,Medio
Liberia           ,50101,38971,90,42,48,10.93167701863354,Medio
Liberia           ,50101,38978,17,12,5,1.8633540372670807,Bajo
Liberia           ,50101,38987,29,12,17,3.354037267080745,Bajo-medio
Liberia           ,50101,38990,30,21,9,3.4782608695652173,Bajo-medio
Liberia           ,50101,39037,55,28,27,6.583850931677018,Medio
Liberia           ,50101,39041,131,67,64,16.024844720496894,Alto-medio
Liberia           ,50101,39061,58,28,30,6.956521739130435,Medio
Liberia           ,50101,39071,53,21,32,6.3354037267080745,Bajo-medio
Liberia           ,50101,39073,44,20,24,5.217391304347826,Bajo-medio
Liberia           ,50101,39080,138,71,67,16.8944099378882,Alto-medio
Liberia           ,50101,39119,78,34,44,9.440993788819876,Medio
Liberia           ,50101,39121,68,30,38,8.198757763975156,Medio
Liberia           ,50101,39122,81,33,48,9.813664596273291,Medio
Liberia           ,50101,39129,41,14,27,4.84472049689441,Bajo-medio
Liberia           ,50101,39132,69,29,40,8.322981366459627,Medio
Liberia           ,50101,39134,65,27,38,7.82608695652174,Medio
Liberia           ,50101,39139,152,70,82,18.633540372670808,Alto-medio
Liberia           ,50101,39140,253,120,133,31.180124223602483,Alto
Liberia           ,50101,39151,22,9,13,2.484472049689441,Bajo
Liberia           ,50101,39156,34,12,22,3.9751552795031055,Bajo-medio
Liberia           ,50101,39158,97,52,45,11.801242236024844,Medio
Liberia           ,50101,39161,78,39,39,9.440993788819876,Medio
Liberia           ,50101,39166,212,112,100,26.08695652173913,Alto
Liberia           ,50101,39171,84,47,37,10.186335403726709,Medio
Liberia           ,50101,39199,60,35,25,7.204968944099378,Medio
Liberia           ,50101,39204,59,24,35,7.080745341614906,Medio
Liberia           ,50101,39210,30,19,11,3.4782608695652173,Bajo-medio
Liberia           ,50101,39214,33,12,21,3.8509316770186333,Bajo-medio
Liberia           ,50101,39218,37,17,20,4.3478260869565215,Bajo-medio
Liberia           ,50101,39251,116,56,60,14.161490683229813,Alto-medio
Liberia           ,50101,39290,168,76,92,20.62111801242236,Alto-medio
Liberia           ,50101,39319,68,31,37,8.198757763975156,Medio
Liberia           ,50101,39320,203,103,100,24.96894409937888,Alto
Liberia           ,50101,39324,123,63,60,15.031055900621118,Alto-medio
Liberia           ,50101,39327,87,45,42,10.559006211180124,Medio
Liberia           ,50101,39334,38,20,18,4.472049689440994,Bajo-medio
Liberia           ,50101,39354,132,64,68,16.149068322981368,Alto-medio
Liberia           ,50101,39356,53,28,25,6.3354037267080745,Bajo-medio
Liberia           ,50101,39379,30,13,17,3.4782608695652173,Bajo-medio
Liberia           ,50101,39380,183,90,93,22.48447204968944,Alto
Liberia           ,50101,39384,31,16,15,3.602484472049689,Bajo-medio
Liberia           ,50101,39413,343,169,174,42.36024844720497,Alto
Liberia           ,50101,39414,77,36,41,9.316770186335404,Medio
Liberia           ,50101,39418,103,62,41,12.546583850931677,Alto-medio
Liberia           ,50101,39421,78,40,38,9.440993788819876,Medio
Liberia           ,50101,39436,58,25,33,6.956521739130435,Medio
Liberia           ,50101,39439,140,69,71,17.142857142857142,Alto-medio
Liberia           ,50101,39454,72,34,38,8.695652173913043,Medio
Liberia           ,50101,39502,45,21,24,5.341614906832298,Bajo-medio
Liberia           ,50101,39507,28,20,8,3.229813664596273,Bajo-medio
Liberia           ,50101,39508,51,21,30,6.086956521739131,Bajo-medio
Liberia           ,50101,39509,95,46,49,11.5527950310559,Medio
Liberia           ,50101,39522,104,51,53,12.670807453416149,Alto-medio
Liberia           ,50101,39525,41,24,17,4.84472049689441,Bajo-medio
Liberia           ,50101,39529,38,22,16,4.472049689440994,Bajo-medio
Liberia           ,50101,39566,33,12,21,3.8509316770186333,Bajo-medio
Liberia           ,50101,39577,23,9,14,2.608695652173913,Bajo
Liberia           ,50101,39580,32,14,18,3.7267080745341614,Bajo-medio
Liberia           ,50101,39581,23,11,12,2.608695652173913,Bajo
Liberia           ,50101,39600,70,34,36,8.4472049689441,Medio
Liberia           ,50101,39616,79,36,43,9.565217391304348,Medio
Liberia           ,50101,39617,134,67,67,16.39751552795031,Alto-medio
Liberia           ,50101,39635,47,20,27,5.590062111801243,Bajo-medio
Liberia           ,50101,39657,25,11,14,2.857142857142857,Bajo-medio
Liberia           ,50101,39674,34,18,16,3.9751552795031055,Bajo-medio
Liberia           ,50101,39696,151,79,72,18.509316770186334,Alto-medio
Liberia           ,50101,39723,113,55,58,13.788819875776397,Alto-medio
Liberia           ,50101,39728,187,92,95,22.981366459627328,Alto
Liberia           ,50101,39732,107,53,54,13.043478260869565,Alto-medio
Liberia           ,50101,39740,38,21,17,4.472049689440994,Bajo-medio
Liberia           ,50101,39772,80,36,44,9.68944099378882,Medio
Liberia           ,50101,39796,265,125,140,32.67080745341615,Alto
Liberia           ,50101,39831,153,70,83,18.757763975155278,Alto-medio
Liberia           ,50101,39905,118,61,57,14.409937888198757,Alto-medio
Liberia           ,50101,39907,120,58,62,14.658385093167702,Alto-medio
Liberia           ,50101,39913,31,16,15,3.602484472049689,Bajo-medio
Liberia           ,50101,39922,84,37,47,10.186335403726709,Medio
Liberia           ,50101,39924,235,104,131,28.944099378881987,Alto
Liberia           ,50101,39933,48,22,26,5.714285714285714,Bajo-medio
Liberia           ,50101,39944,73,40,33,8.819875776397515,Medio
Liberia           ,50101,39947,82,34,48,9.937888198757763,Medio
Liberia           ,50101,39964,56,28,28,6.70807453416149,Medio
Liberia           ,50101,39982,114,54,60,13.91304347826087,Alto-medio
Liberia           ,50101,39998,144,64,80,17.63975155279503,Alto-medio
Liberia           ,50101,39999,52,23,29,6.211180124223603,Bajo-medio
Liberia           ,50101,40011,21,8,13,2.360248447204969,Bajo
Liberia           ,50101,40016,212,94,118,26.08695652173913,Alto
Liberia           ,50101,40025,42,18,24,4.968944099378882,Bajo-medio
Liberia           ,50101,40032,68,31,37,8.198757763975156,Medio
Liberia           ,50101,40038,74,39,35,8.944099378881988,Medio
Liberia           ,50101,40089,60,27,33,7.204968944099378,Medio
Liberia           ,50101,40128,46,20,26,5.46583850931677,Bajo-medio
Liberia           ,50101,40134,239,104,135,29.440993788819874,Alto
Liberia           ,50101,40158,19,7,12,2.111801242236025,Bajo
Liberia           ,50101,40231,54,27,27,6.459627329192546,Medio
Liberia           ,50101,40233,135,57,78,16.52173913043478,Alto-medio
Liberia           ,50101,40242,56,30,26,6.70807453416149,Medio
Liberia           ,50101,40250,72,41,31,8.695652173913043,Medio
Liberia           ,50101,40276,73,39,34,8.819875776397515,Medio
Liberia           ,50101,40286,35,20,15,4.099378881987578,Bajo-medio
Liberia           ,50101,40313,77,45,32,9.316770186335404,Medio
Liberia           ,50101,40327,46,24,22,5.46583850931677,Bajo-medio
Liberia           ,50101,40328,17,9,8,1.8633540372670807,Bajo
Liberia           ,50101,40340,80,35,45,9.68944099378882,Medio
Liberia           ,50101,40419,84,39,45,10.186335403726709,Medio
Liberia           ,50101,40422,51,28,23,6.086956521739131,Bajo-medio
Liberia           ,50101,40424,102,53,49,12.422360248447205,Alto-medio
Liberia           ,50101,40437,45,21,24,5.341614906832298,Bajo-medio
Liberia           ,50101,40441,98,45,53,11.925465838509316,Medio
Liberia           ,50101,40463,35,18,17,4.099378881987578,Bajo-medio
Liberia           ,50101,40465,60,33,27,7.204968944099378,Medio
Liberia           ,50101,40467,55,24,31,6.583850931677018,Medio
Liberia           ,50101,40496,166,80,86,20.372670807453417,Alto-medio
Liberia           ,50101,40523,47,22,25,5.590062111801243,Bajo-medio
Liberia           ,50101,40529,56,27,29,6.70807453416149,Medio
Liberia           ,50101,40534,58,29,29,6.956521739130435,Medio
Liberia           ,50101,40547,60,30,30,7.204968944099378,Medio
Liberia           ,50101,40574,35,17,18,4.099378881987578,Bajo-medio
Liberia           ,50101,40589,66,30,36,7.950310559006211,Medio
Liberia           ,50101,40611,23,13,10,2.608695652173913,Bajo
Liberia           ,50101,40612,23,11,12,2.608695652173913,Bajo
Liberia           ,50101,40634,43,22,21,5.093167701863354,Bajo-medio
Liberia           ,50101,40652,55,24,31,6.583850931677018,Medio
Liberia           ,50101,40662,137,76,61,16.77018633540373,Alto-medio
Liberia           ,50101,40668,152,79,73,18.633540372670808,Alto-medio
Liberia           ,50101,40676,24,13,11,2.732919254658385,Bajo
Liberia           ,50101,40683,118,54,64,14.409937888198757,Alto-medio
Liberia           ,50101,40686,113,53,60,13.788819875776397,Alto-medio
Liberia           ,50101,40704,70,35,35,8.4472049689441,Medio
Liberia           ,50101,40735,230,114,116,28.322981366459626,Alto
Liberia           ,50101,40736,57,27,30,6.832298136645963,Medio
Liberia           ,50101,40741,95,45,50,11.5527950310559,Medio
Liberia           ,50101,40744,132,60,72,16.149068322981368,Alto-medio
Liberia           ,50101,40747,26,12,14,2.981366459627329,Bajo-medio
Liberia           ,50101,40752,120,65,55,14.658385093167702,Alto-medio
Liberia           ,50101,40755,295,140,155,36.39751552795031,Alto
Liberia           ,50101,40764,67,34,33,8.074534161490684,Medio
Liberia           ,50101,40782,45,20,25,5.341614906832298,Bajo-medio
Liberia           ,50101,40827,82,41,41,9.937888198757763,Medio
Liberia           ,50101,40828,65,33,32,7.82608695652174,Medio
Liberia           ,50101,40844,57,24,33,6.832298136645963,Medio
Liberia           ,50101,40845,74,40,34,8.944099378881988,Medio
Liberia           ,50101,40860,56,29,27,6.70807453416149,Medio
Liberia           ,50101,40864,18,11,7,1.9875776397515528,Bajo
Liberia           ,50101,40865,39,17,22,4.596273291925466,Bajo-medio
Liberia           ,50101,40914,119,49,70,14.534161490683232,Alto-medio
Liberia           ,50101,40925,171,84,87,20.99378881987578,Alto-medio
Liberia           ,50101,40937,58,27,31,6.956521739130435,Medio
Liberia           ,50101,40950,39,17,22,4.596273291925466,Bajo-medio
Liberia           ,50101,40951,119,54,65,14.534161490683232,Alto-medio
Liberia           ,50101,40958,123,62,61,15.031055900621118,Alto-medio
Liberia           ,50101,40961,114,51,63,13.91304347826087,Alto-medio
Liberia           ,50101,40981,56,30,26,6.70807453416149,Medio
Liberia           ,50101,41013,23,8,15,2.608695652173913,Bajo
Liberia           ,50101,41014,22,11,11,2.484472049689441,Bajo
Liberia           ,50101,41022,56,33,23,6.70807453416149,Medio
Liberia           ,50101,41041,99,48,51,12.049689440993788,Medio
Liberia           ,50101,41048,77,35,42,9.316770186335404,Medio
Liberia           ,50101,41051,176,81,95,21.614906832298136,Alto
Liberia           ,50101,41065,143,70,73,17.51552795031056,Alto-medio
Liberia           ,50101,41075,63,32,31,7.577639751552795,Medio
Liberia           ,50101,41168,97,46,51,11.801242236024844,Medio
Liberia           ,50101,41169,92,44,48,11.180124223602485,Medio
Liberia           ,50101,41206,119,54,65,14.534161490683232,Alto-medio
Liberia           ,50101,41231,21,7,14,2.360248447204969,Bajo
Liberia           ,50101,41279,22,12,10,2.484472049689441,Bajo
Liberia           ,50101,41284,121,64,57,14.782608695652174,Alto-medio
Liberia           ,50101,41322,107,49,58,13.043478260869565,Alto-medio
Liberia           ,50101,41345,62,31,31,7.453416149068323,Medio
Liberia           ,50101,41378,128,60,68,15.65217391304348,Alto-medio
Liberia           ,50101,41392,18,8,10,1.9875776397515528,Bajo
Liberia           ,50101,41400,45,24,21,5.341614906832298,Bajo-medio
Liberia           ,50101,41428,68,31,37,8.198757763975156,Medio
Liberia           ,50101,41429,40,21,19,4.720496894409938,Bajo-medio
Liberia           ,50101,41455,175,79,96,21.490683229813666,Alto-medio
Liberia           ,50101,41460,53,31,22,6.3354037267080745,Bajo-medio
Liberia           ,50101,41487,60,28,32,7.204968944099378,Medio
Liberia           ,50101,41489,113,52,61,13.788819875776397,Alto-medio
Liberia           ,50101,41493,130,64,66,15.900621118012422,Alto-medio
Liberia           ,50101,41505,47,23,24,5.590062111801243,Bajo-medio
Liberia           ,50101,41518,129,60,69,15.77639751552795,Alto-medio
Liberia           ,50101,41554,27,15,12,3.1055900621118013,Bajo-medio
Liberia           ,50101,41560,24,10,14,2.732919254658385,Bajo
Liberia           ,50101,41564,30,16,14,3.4782608695652173,Bajo-medio
Liberia           ,50101,41587,44,22,22,5.217391304347826,Bajo-medio
Liberia           ,50101,41590,60,29,31,7.204968944099378,Medio
Liberia           ,50101,41592,64,28,36,7.7018633540372665,Medio
Liberia           ,50101,41599,44,23,21,5.217391304347826,Bajo-medio
Liberia           ,50101,41600,53,32,21,6.3354037267080745,Bajo-medio
Liberia           ,50101,41620,102,51,51,12.422360248447205,Alto-medio
Liberia           ,50101,41647,108,55,53,13.167701863354036,Alto-medio
Liberia           ,50101,41676,56,26,30,6.70807453416149,Medio
Liberia           ,50101,41680,64,31,33,7.7018633540372665,Medio
Liberia           ,50101,41693,33,15,18,3.8509316770186333,Bajo-medio
Liberia           ,50101,41696,12,6,6,1.2422360248447204,Bajo
Liberia           ,50101,41703,48,20,28,5.714285714285714,Bajo-medio
Liberia           ,50101,41716,30,13,17,3.4782608695652173,Bajo-medio
Liberia           ,50101,41726,65,33,32,7.82608695652174,Medio
Liberia           ,50101,41748,68,31,37,8.198757763975156,Medio
Liberia           ,50101,41787,236,110,126,29.068322981366464,Alto
Liberia           ,50101,41797,64,32,32,7.7018633540372665,Medio
Liberia           ,50101,41799,36,14,22,4.22360248447205,Bajo-medio
Liberia           ,50101,41822,126,61,65,15.403726708074533,Alto-medio
Liberia           ,50101,41823,128,58,70,15.65217391304348,Alto-medio
Liberia           ,50101,41848,130,59,71,15.900621118012422,Alto-medio
Liberia           ,50101,41900,86,38,48,10.434782608695652,Medio
Liberia           ,50101,41921,41,17,24,4.84472049689441,Bajo-medio
Liberia           ,50101,41925,54,25,29,6.459627329192546,Medio
Liberia           ,50101,41955,133,61,72,16.273291925465838,Alto-medio
Liberia           ,50101,41969,57,28,29,6.832298136645963,Medio
Liberia           ,50101,41971,73,34,39,8.819875776397515,Medio
Liberia           ,50101,41972,77,44,33,9.316770186335404,Medio
Liberia           ,50101,41988,69,30,39,8.322981366459627,Medio
Liberia           ,50101,42017,58,32,26,6.956521739130435,Medio
Liberia           ,50101,42029,57,27,30,6.832298136645963,Medio
Liberia           ,50101,42035,93,46,47,11.304347826086957,Medio
Liberia           ,50101,42040,60,31,29,7.204968944099378,Medio
Liberia           ,50101,42049,57,27,30,6.832298136645963,Medio
Liberia           ,50101,42064,48,24,24,5.714285714285714,Bajo-medio
Liberia           ,50101,42067,95,49,46,11.5527950310559,Medio
Liberia           ,50101,42074,105,43,62,12.79503105590062,Alto-medio
Liberia           ,50101,42090,172,80,92,21.11801242236025,Alto-medio
Liberia           ,50101,42157,127,64,63,15.527950310559005,Alto-medio
Liberia           ,50101,42158,66,40,26,7.950310559006211,Medio
Liberia           ,50101,42169,66,31,35,7.950310559006211,Medio
Liberia           ,50101,42188,30,14,16,3.4782608695652173,Bajo-medio
Liberia           ,50101,42201,61,25,36,7.329192546583851,Medio
Liberia           ,50101,42220,164,74,90,20.124223602484474,Alto-medio
Liberia           ,50101,42223,142,61,81,17.391304347826086,Alto-medio
Liberia           ,50101,42244,136,70,66,16.645962732919255,Alto-medio
Liberia           ,50101,42258,83,39,44,10.062111801242237,Medio
Liberia           ,50101,42271,79,39,40,9.565217391304348,Medio
Liberia           ,50101,42275,234,113,121,28.819875776397513,Alto
Liberia           ,50101,42283,127,55,72,15.527950310559005,Alto-medio
Liberia           ,50101,42287,39,15,24,4.596273291925466,Bajo-medio
Liberia           ,50101,42316,59,28,31,7.080745341614906,Medio
Liberia           ,50101,42337,80,38,42,9.68944099378882,Medio
Liberia           ,50101,42341,103,48,55,12.546583850931677,Alto-medio
Liberia           ,50101,42343,56,28,28,6.70807453416149,Medio
Liberia           ,50101,42382,62,22,40,7.453416149068323,Medio
Liberia           ,50101,42399,36,11,25,4.22360248447205,Bajo-medio
Liberia           ,50101,42402,36,14,22,4.22360248447205,Bajo-medio
Liberia           ,50101,42413,182,93,89,22.36024844720497,Alto
Liberia           ,50101,42436,136,70,66,16.645962732919255,Alto-medio
Liberia           ,50101,42446,83,40,43,10.062111801242237,Medio
Liberia           ,50101,42451,49,22,27,5.838509316770186,Bajo-medio
Liberia           ,50101,42472,143,66,77,17.51552795031056,Alto-medio
Liberia           ,50101,42478,22,10,12,2.484472049689441,Bajo
Liberia           ,50101,42487,308,145,163,38.01242236024845,Alto
Liberia           ,50101,42499,29,15,14,3.354037267080745,Bajo-medio
Liberia           ,50101,42550,82,40,42,9.937888198757763,Medio
Liberia           ,50101,42557,109,50,59,13.291925465838508,Alto-medio
Liberia           ,50101,42562,5,3,2,0.37267080745341613,Bajo
Liberia           ,50101,42566,55,26,29,6.583850931677018,Medio
Liberia           ,50101,42574,57,30,27,6.832298136645963,Medio
Liberia           ,50101,42577,137,62,75,16.77018633540373,Alto-medio
Liberia           ,50101,42594,70,34,36,8.4472049689441,Medio
Liberia           ,50101,42596,14,7,7,1.4906832298136645,Bajo
Liberia           ,50101,42628,66,27,39,7.950310559006211,Medio
Liberia           ,50101,42652,234,123,111,28.819875776397513,Alto
Liberia           ,50101,42669,24,13,11,2.732919254658385,Bajo
Liberia           ,50101,42671,82,43,39,9.937888198757763,Medio
Liberia           ,50101,42678,63,24,39,7.577639751552795,Medio
Liberia           ,50101,42697,51,28,23,6.086956521739131,Bajo-medio
Liberia           ,50101,42700,189,88,101,23.229813664596275,Alto
Liberia           ,50101,42707,154,66,88,18.88198757763975,Alto-medio
Liberia           ,50101,42716,466,227,239,57.639751552795026,Alto
Liberia           ,50101,42749,52,26,26,6.211180124223603,Bajo-medio
Liberia           ,50101,42767,53,24,29,6.3354037267080745,Bajo-medio
Liberia           ,50101,42769,268,138,130,33.04347826086956,Alto
Liberia           ,50101,42770,27,15,12,3.1055900621118013,Bajo-medio
Liberia           ,50101,42771,16,10,6,1.7391304347826086,Bajo
Liberia           ,50101,42778,166,80,86,20.372670807453417,Alto-medio
Liberia           ,50101,42780,107,43,64,13.043478260869565,Alto-medio
Liberia           ,50101,42791,57,25,32,6.832298136645963,Medio
Liberia           ,50101,42793,79,37,42,9.565217391304348,Medio
Liberia           ,50101,42830,146,78,68,17.888198757763977,Alto-medio
Liberia           ,50101,42833,53,35,18,6.3354037267080745,Bajo-medio
Liberia           ,50101,42836,398,191,207,49.192546583850934,Alto
Liberia           ,50101,42857,8,4,4,0.7453416149068323,Bajo
Liberia           ,50101,42864,90,39,51,10.93167701863354,Medio
Liberia           ,50101,42878,536,271,265,66.33540372670808,Alto
Liberia           ,50101,42882,13,5,8,1.3664596273291925,Bajo
Liberia           ,50101,42884,57,25,32,6.832298136645963,Medio
Liberia           ,50101,42925,122,60,62,14.906832298136646,Alto-medio
Liberia           ,50101,42941,62,32,30,7.453416149068323,Medio
Liberia           ,50101,43000,28,17,11,3.229813664596273,Bajo-medio
Liberia           ,50101,43003,88,43,45,10.683229813664596,Medio
Liberia           ,50101,43006,6,3,3,0.4968944099378882,Bajo
Liberia           ,50101,43013,83,36,47,10.062111801242237,Medio
Liberia           ,50101,43017,119,58,61,14.534161490683232,Alto-medio
Liberia           ,50101,43043,17,6,11,1.8633540372670807,Bajo
Liberia           ,50101,43080,81,40,41,9.813664596273291,Medio
Liberia           ,50101,43102,87,47,40,10.559006211180124,Medio
Liberia           ,50101,43124,22,10,12,2.484472049689441,Bajo
Liberia           ,50101,43141,118,54,64,14.409937888198757,Alto-medio
Liberia           ,50101,43145,20,11,9,2.236024844720497,Bajo
Liberia           ,50101,43168,10,5,5,0.9937888198757764,Bajo
Liberia           ,50101,43177,118,53,65,14.409937888198757,Alto-medio
Liberia           ,50101,43179,55,27,28,6.583850931677018,Medio
Liberia           ,50101,43181,64,28,36,7.7018633540372665,Medio
Liberia           ,50101,43189,10,4,6,0.9937888198757764,Bajo
Liberia           ,50101,43194,56,27,29,6.70807453416149,Medio
Liberia           ,50101,43221,36,20,16,4.22360248447205,Bajo-medio
Liberia           ,50101,43224,97,47,50,11.801242236024844,Medio
Liberia           ,50101,43248,72,32,40,8.695652173913043,Medio
Liberia           ,50101,43268,65,35,30,7.82608695652174,Medio
Liberia           ,50101,43272,32,17,15,3.7267080745341614,Bajo-medio
Liberia           ,50101,43278,19,10,9,2.111801242236025,Bajo
Liberia           ,50101,43324,74,29,45,8.944099378881988,Medio
Liberia           ,50101,43336,392,191,201,48.4472049689441,Alto
Liberia           ,50101,43346,59,27,32,7.080745341614906,Medio
Liberia           ,50101,43393,32,13,19,3.7267080745341614,Bajo-medio
Liberia           ,50101,43403,43,20,23,5.093167701863354,Bajo-medio
Liberia           ,50101,43438,116,55,61,14.161490683229813,Alto-medio
Liberia           ,50101,43439,188,89,99,23.1055900621118,Alto
Liberia           ,50101,43450,91,47,44,11.055900621118013,Medio
Liberia           ,50101,43454,106,56,50,12.919254658385093,Alto-medio
Liberia           ,50101,43486,110,53,57,13.41614906832298,Alto-medio
Liberia           ,50101,43489,50,18,32,5.962732919254658,Bajo-medio
Liberia           ,50101,43503,97,45,52,11.801242236024844,Medio
Liberia           ,50101,43513,24,9,15,2.732919254658385,Bajo
Liberia           ,50101,43514,141,68,73,17.267080745341616,Alto-medio
Liberia           ,50101,43516,123,57,66,15.031055900621118,Alto-medio
Liberia           ,50101,43521,63,27,36,7.577639751552795,Medio
Liberia           ,50101,43560,53,22,31,6.3354037267080745,Bajo-medio
Liberia           ,50101,43562,79,36,43,9.565217391304348,Medio
Liberia           ,50101,43572,116,52,64,14.161490683229813,Alto-medio
Liberia           ,50101,43577,55,27,28,6.583850931677018,Medio
Liberia           ,50101,43584,53,24,29,6.3354037267080745,Bajo-medio
Liberia           ,50101,43586,65,31,34,7.82608695652174,Medio
Liberia           ,50101,43592,43,21,22,5.093167701863354,Bajo-medio
Liberia           ,50101,43611,43,17,26,5.093167701863354,Bajo-medio
Liberia           ,50101,43616,57,36,21,6.832298136645963,Medio
Liberia           ,50101,43634,137,59,78,16.77018633540373,Alto-medio
Liberia           ,50101,43653,51,29,22,6.086956521739131,Bajo-medio
Liberia           ,50101,43656,70,34,36,8.4472049689441,Medio
Liberia           ,50101,43659,60,22,38,7.204968944099378,Medio
Liberia           ,50101,43662,70,35,35,8.4472049689441,Medio
Liberia           ,50101,43664,66,37,29,7.950310559006211,Medio
Liberia           ,50101,43713,122,59,63,14.906832298136646,Alto-medio
Liberia           ,50101,43717,95,36,59,11.5527950310559,Medio
Liberia           ,50101,43720,83,40,43,10.062111801242237,Medio
Liberia           ,50101,43722,47,22,25,5.590062111801243,Bajo-medio
Liberia           ,50101,43733,148,84,64,18.13664596273292,Alto-medio
Liberia           ,50101,43734,88,47,41,10.683229813664596,Medio
Liberia           ,50101,43763,121,61,60,14.782608695652174,Alto-medio
Liberia           ,50101,43767,69,33,36,8.322981366459627,Medio
Liberia           ,50101,43771,177,89,88,21.73913043478261,Alto
Liberia           ,50101,43795,87,45,42,10.559006211180124,Medio
Liberia           ,50101,43815,132,62,70,16.149068322981368,Alto-medio
Liberia           ,50101,43822,108,50,58,13.167701863354036,Alto-medio
Liberia           ,50101,43835,118,57,61,14.409937888198757,Alto-medio
Liberia           ,50101,43869,282,153,129,34.78260869565217,Alto
Liberia           ,50101,43874,28,9,19,3.229813664596273,Bajo-medio
Liberia           ,50101,43884,81,38,43,9.813664596273291,Medio
Liberia           ,50101,43908,62,31,31,7.453416149068323,Medio
Liberia           ,50101,43910,55,33,22,6.583850931677018,Medio
Liberia           ,50101,43927,19,8,11,2.111801242236025,Bajo
Liberia           ,50101,43950,203,94,109,24.96894409937888,Alto
Liberia           ,50101,43984,115,54,61,14.037267080745341,Alto-medio
Liberia           ,50101,43992,89,46,43,10.807453416149068,Medio
Liberia           ,50101,44006,117,52,65,14.285714285714285,Alto-medio
Liberia           ,50101,44010,89,39,50,10.807453416149068,Medio
Liberia           ,50101,44014,98,44,54,11.925465838509316,Medio
Liberia           ,50101,44036,130,64,66,15.900621118012422,Alto-medio
Liberia           ,50101,44041,84,44,40,10.186335403726709,Medio
Liberia           ,50101,44043,32,14,18,3.7267080745341614,Bajo-medio
Liberia           ,50101,44044,47,21,26,5.590062111801243,Bajo-medio
Liberia           ,50101,44047,41,18,23,4.84472049689441,Bajo-medio
Liberia           ,50101,44063,113,57,56,13.788819875776397,Alto-medio
Liberia           ,50101,44081,102,47,55,12.422360248447205,Alto-medio
Liberia           ,50101,44085,84,35,49,10.186335403726709,Medio
Liberia           ,50101,44101,43,18,25,5.093167701863354,Bajo-medio
Liberia           ,50101,44126,51,19,32,6.086956521739131,Bajo-medio
Liberia           ,50101,44145,23,7,16,2.608695652173913,Bajo
Liberia           ,50101,44161,75,32,43,9.06832298136646,Medio
Liberia           ,50101,44167,190,83,107,23.354037267080745,Alto
Liberia           ,50101,44193,31,19,12,3.602484472049689,Bajo-medio
Liberia           ,50101,44203,163,72,91,20.0,Alto-medio
Liberia           ,50101,44237,47,22,25,5.590062111801243,Bajo-medio
Liberia           ,50101,44258,65,28,37,7.82608695652174,Medio
Liberia           ,50101,44259,807,685,122,100.0,Alto
Liberia           ,50101,44263,41,20,21,4.84472049689441,Bajo-medio
Liberia           ,50101,44273,77,34,43,9.316770186335404,Medio
Liberia           ,50101,44317,131,71,60,16.024844720496894,Alto-medio
Liberia           ,50101,44329,37,17,20,4.3478260869565215,Bajo-medio
Liberia           ,50101,44344,119,57,62,14.534161490683232,Alto-medio
Liberia           ,50101,44363,12,7,5,1.2422360248447204,Bajo
Liberia           ,50101,44375,146,67,79,17.888198757763977,Alto-medio
Liberia           ,50101,44382,124,64,60,15.15527950310559,Alto-medio
Liberia           ,50101,44387,37,18,19,4.3478260869565215,Bajo-medio
Liberia           ,50101,44451,53,28,25,6.3354037267080745,Bajo-medio
Liberia           ,50101,44471,32,21,11,3.7267080745341614,Bajo-medio
Liberia           ,50101,44485,53,27,26,6.3354037267080745,Bajo-medio
Liberia           ,50101,44497,70,32,38,8.4472049689441,Medio
Liberia           ,50101,44511,41,15,26,4.84472049689441,Bajo-medio
Liberia           ,50101,44513,44,23,21,5.217391304347826,Bajo-medio
Liberia           ,50101,44524,75,34,41,9.06832298136646,Medio
Liberia           ,50101,44539,38,18,20,4.472049689440994,Bajo-medio
Liberia           ,50101,44543,78,34,44,9.440993788819876,Medio
Liberia           ,50101,44577,236,119,117,29.068322981366464,Alto
Liberia           ,50101,44583,126,62,64,15.403726708074533,Alto-medio
Liberia           ,50101,44667,53,25,28,6.3354037267080745,Bajo-medio
Liberia           ,50101,44679,74,38,36,8.944099378881988,Medio
Liberia           ,50101,44683,56,19,37,6.70807453416149,Medio
Liberia           ,50101,44684,23,13,10,2.608695652173913,Bajo
Liberia           ,50101,44690,43,26,17,5.093167701863354,Bajo-medio
Liberia           ,50101,44729,248,166,82,30.559006211180122,Alto
Liberia           ,50101,44732,90,31,59,10.93167701863354,Medio
Liberia           ,50101,44745,30,17,13,3.4782608695652173,Bajo-medio
Liberia           ,50101,44761,113,58,55,13.788819875776397,Alto-medio
Liberia           ,50101,44763,55,23,32,6.583850931677018,Medio
Liberia           ,50101,44776,10,5,5,0.9937888198757764,Bajo
Liberia           ,50101,44791,119,52,67,14.534161490683232,Alto-medio
Liberia           ,50101,44795,311,157,154,38.38509316770186,Alto
Liberia           ,50101,44805,51,30,21,6.086956521739131,Bajo-medio
Liberia           ,50101,44819,51,24,27,6.086956521739131,Bajo-medio
Liberia           ,50101,44839,102,50,52,12.422360248447205,Alto-medio
Liberia           ,50101,44844,4,1,3,0.2484472049689441,Bajo
Liberia           ,50101,44860,175,89,86,21.490683229813666,Alto-medio
Liberia           ,50101,44863,131,58,73,16.024844720496894,Alto-medio
Liberia           ,50101,44882,54,25,29,6.459627329192546,Medio
Liberia           ,50101,44895,144,75,69,17.63975155279503,Alto-medio
Liberia           ,50101,44906,69,35,34,8.322981366459627,Medio
Liberia           ,50101,44907,242,118,124,29.81366459627329,Alto
Liberia           ,50101,44938,147,57,90,18.012422360248447,Alto-medio
Liberia           ,50101,44943,85,39,46,10.31055900621118,Medio
Liberia           ,50101,44985,29,10,19,3.354037267080745,Bajo-medio
Liberia           ,50101,44986,87,40,47,10.559006211180124,Medio
Liberia           ,50101,44989,160,74,86,19.627329192546583,Alto-medio
Liberia           ,50101,44994,142,59,83,17.391304347826086,Alto-medio
Liberia           ,50101,45011,195,103,92,23.975155279503106,Alto
Liberia           ,50101,45019,48,19,29,5.714285714285714,Bajo-medio
Liberia           ,50101,45029,118,51,67,14.409937888198757,Alto-medio
Liberia           ,50101,45030,34,12,22,3.9751552795031055,Bajo-medio
Liberia           ,50101,45033,69,31,38,8.322981366459627,Medio
Liberia           ,50101,45045,57,27,30,6.832298136645963,Medio
Liberia           ,50101,45085,223,113,110,27.45341614906832,Alto
Liberia           ,50101,45093,20,7,13,2.236024844720497,Bajo
Liberia           ,50101,45095,41,20,21,4.84472049689441,Bajo-medio
Liberia           ,50101,45118,126,61,65,15.403726708074533,Alto-medio
Liberia           ,50101,45123,47,27,20,5.590062111801243,Bajo-medio
Liberia           ,50101,45139,311,146,165,38.38509316770186,Alto
Liberia           ,50101,45220,41,23,18,4.84472049689441,Bajo-medio
Liberia           ,50101,45246,120,63,57,14.658385093167702,Alto-medio
Liberia           ,50101,45260,64,28,36,7.7018633540372665,Medio
Liberia           ,50101,45289,48,16,32,5.714285714285714,Bajo-medio
Liberia           ,50101,45330,118,62,56,14.409937888198757,Alto-medio
Liberia           ,50101,45357,78,37,41,9.440993788819876,Medio
Liberia           ,50101,45363,79,39,40,9.565217391304348,Medio
Liberia           ,50101,45376,79,35,44,9.565217391304348,Medio
Liberia           ,50101,45377,65,31,34,7.82608695652174,Medio
Liberia           ,50101,45384,75,32,43,9.06832298136646,Medio
Liberia           ,50101,45396,83,43,40,10.062111801242237,Medio
Liberia           ,50101,45401,127,68,59,15.527950310559005,Alto-medio
Liberia           ,50101,45423,46,17,29,5.46583850931677,Bajo-medio
Liberia           ,50101,45424,57,32,25,6.832298136645963,Medio
Liberia           ,50101,45453,75,40,35,9.06832298136646,Medio
Liberia           ,50101,45481,50,19,31,5.962732919254658,Bajo-medio
Liberia           ,50101,45529,41,20,21,4.84472049689441,Bajo-medio
Liberia           ,50101,45547,107,64,43,13.043478260869565,Alto-medio
Liberia           ,50101,45589,34,12,22,3.9751552795031055,Bajo-medio
Liberia           ,50101,45593,32,14,18,3.7267080745341614,Bajo-medio
Liberia           ,50101,45606,34,15,19,3.9751552795031055,Bajo-medio
Liberia           ,50101,45647,127,66,61,15.527950310559005,Alto-medio
Liberia           ,50101,45682,94,45,49,11.428571428571429,Medio
Liberia           ,50101,45710,138,67,71,16.8944099378882,Alto-medio
Liberia           ,50101,45718,52,25,27,6.211180124223603,Bajo-medio
Liberia           ,50101,45796,103,57,46,12.546583850931677,Alto-medio
Liberia           ,50101,45797,138,71,67,16.8944099378882,Alto-medio
Liberia           ,50101,45838,19,12,7,2.111801242236025,Bajo
Liberia           ,50101,45841,95,47,48,11.5527950310559,Medio
Liberia           ,50101,45891,64,34,30,7.7018633540372665,Medio
Liberia           ,50101,45892,62,34,28,7.453416149068323,Medio
Liberia           ,50101,45899,62,30,32,7.453416149068323,Medio
Liberia           ,50101,45917,40,17,23,4.720496894409938,Bajo-medio
Liberia           ,50101,45923,131,63,68,16.024844720496894,Alto-medio
Liberia           ,50101,45927,258,138,120,31.801242236024844,Alto
Liberia           ,50101,45934,73,35,38,8.819875776397515,Medio
Liberia           ,50101,45956,148,64,84,18.13664596273292,Alto-medio
Liberia           ,50101,45990,75,36,39,9.06832298136646,Medio
Liberia           ,50101,46000,57,30,27,6.832298136645963,Medio
Liberia           ,50101,46003,43,20,23,5.093167701863354,Bajo-medio
Liberia           ,50101,46005,73,44,29,8.819875776397515,Medio
Liberia           ,50101,46010,161,75,86,19.751552795031056,Alto-medio
Liberia           ,50101,46020,48,23,25,5.714285714285714,Bajo-medio
Liberia           ,50101,72419,121,63,58,14.782608695652174,Alto-medio
Liberia           ,50101,72420,44,24,20,5.217391304347826,Bajo-medio
Liberia           ,50101,72421,79,44,35,9.565217391304348,Medio
Liberia           ,50101,72422,15,8,7,1.6149068322981366,Bajo
Liberia           ,50101,72423,124,65,59,15.15527950310559,Alto-medio
Liberia           ,50101,72424,87,42,45,10.559006211180124,Medio
Liberia           ,50101,72425,108,56,52,13.167701863354036,Alto-medio
Liberia           ,50101,72426,233,103,130,28.695652173913043,Alto
Liberia           ,50101,72427,92,43,49,11.180124223602485,Medio
Liberia           ,50101,72428,130,71,59,15.900621118012422,Alto-medio
Liberia           ,50101,72429,178,103,75,21.86335403726708,Alto
Liberia           ,50101,72430,189,86,103,23.229813664596275,Alto
Liberia           ,50101,72431,112,56,56,13.664596273291925,Alto-medio
Liberia           ,50101,72432,243,136,107,29.93788819875776,Alto
Liberia           ,50101,72433,378,191,187,46.70807453416149,Alto
Liberia           ,50101,72434,256,128,128,31.5527950310559,Alto
Liberia           ,50101,72435,159,84,75,19.503105590062113,Alto-medio
Liberia           ,50101,72436,131,67,64,16.024844720496894,Alto-medio
Liberia           ,50101,72437,23,12,11,2.608695652173913,Bajo
Liberia           ,50101,72438,157,70,87,19.25465838509317,Alto-medio
Liberia           ,50101,72439,206,93,113,25.341614906832298,Alto
Liberia           ,50101,72440,99,41,58,12.049689440993788,Medio
Liberia           ,50101,72441,119,51,68,14.534161490683232,Alto-medio
Liberia           ,50101,72442,87,36,51,10.559006211180124,Medio
Liberia           ,50101,72443,215,105,110,26.459627329192546,Alto
Liberia           ,50101,72444,124,61,63,15.15527950310559,Alto-medio
Liberia           ,50101,72445,143,74,69,17.51552795031056,Alto-medio
Liberia           ,50101,72446,154,70,84,18.88198757763975,Alto-medio
Liberia           ,50101,72447,269,150,119,33.16770186335404,Alto
Liberia           ,50101,72448,259,124,135,31.925465838509314,Alto
Liberia           ,50101,72449,294,138,156,36.27329192546584,Alto
Liberia           ,50101,72450,262,110,152,32.298136645962735,Alto
Liberia           ,50101,72451,212,106,106,26.08695652173913,Alto
Liberia           ,50101,72452,167,74,93,20.496894409937887,Alto-medio
Liberia           ,50101,72453,213,104,109,26.211180124223603,Alto
Liberia           ,50101,72454,127,70,57,15.527950310559005,Alto-medio
Liberia           ,50101,72455,51,28,23,6.086956521739131,Bajo-medio
Liberia           ,50101,72456,69,38,31,8.322981366459627,Medio
Liberia           ,50101,72457,166,74,92,20.372670807453417,Alto-medio
Liberia           ,50101,72458,8,6,2,0.7453416149068323,Bajo
Liberia           ,50101,72459,157,73,84,19.25465838509317,Alto-medio
Liberia           ,50101,72460,25,16,9,2.857142857142857,Bajo-medio
Liberia           ,50101,72461,45,26,19,5.341614906832298,Bajo-medio
Liberia           ,50101,72842,21,8,13,2.360248447204969,Bajo
Cañas Dulces      ,50102,154,70,34,36,8.4472049689441,Medio
Cañas Dulces      ,50102,769,33,16,17,3.8509316770186333,Bajo-medio
Cañas Dulces      ,50102,2406,63,33,30,7.577639751552795,Medio
Cañas Dulces      ,50102,2887,9,3,6,0.8695652173913043,Bajo
Cañas Dulces      ,50102,7600,91,47,44,11.055900621118013,Medio
Cañas Dulces      ,50102,9217,61,29,32,7.329192546583851,Medio
Cañas Dulces      ,50102,10925,22,11,11,2.484472049689441,Bajo
Cañas Dulces      ,50102,12666,51,24,27,6.086956521739131,Bajo-medio
Cañas Dulces      ,50102,14543,102,48,54,12.422360248447205,Alto-medio
Cañas Dulces      ,50102,15738,60,34,26,7.204968944099378,Medio
Cañas Dulces      ,50102,19816,100,51,49,12.173913043478262,Alto-medio
Cañas Dulces      ,50102,20249,161,78,83,19.751552795031056,Alto-medio
Cañas Dulces      ,50102,20998,44,24,20,5.217391304347826,Bajo-medio
Cañas Dulces      ,50102,21713,101,50,51,12.298136645962733,Alto-medio
Cañas Dulces      ,50102,22735,13,5,8,1.3664596273291925,Bajo
Cañas Dulces      ,50102,23147,87,42,45,10.559006211180124,Medio
Cañas Dulces      ,50102,26437,120,62,58,14.658385093167702,Alto-medio
Cañas Dulces      ,50102,26617,189,93,96,23.229813664596275,Alto
Cañas Dulces      ,50102,29528,50,24,26,5.962732919254658,Bajo-medio
Cañas Dulces      ,50102,30219,126,56,70,15.403726708074533,Alto-medio
Cañas Dulces      ,50102,32903,133,65,68,16.273291925465838,Alto-medio
Cañas Dulces      ,50102,33318,264,152,112,32.546583850931675,Alto
Cañas Dulces      ,50102,71397,86,46,40,10.434782608695652,Medio
Cañas Dulces      ,50102,71398,40,16,24,4.720496894409938,Bajo-medio
Cañas Dulces      ,50102,71399,201,99,102,24.720496894409937,Alto
Cañas Dulces      ,50102,71400,156,84,72,19.130434782608695,Alto-medio
Cañas Dulces      ,50102,71401,135,70,65,16.52173913043478,Alto-medio
Cañas Dulces      ,50102,71402,179,83,96,21.987577639751553,Alto
Cañas Dulces      ,50102,71403,171,78,93,20.99378881987578,Alto-medio
Cañas Dulces      ,50102,71404,136,71,65,16.645962732919255,Alto-medio
Cañas Dulces      ,50102,71405,176,102,74,21.614906832298136,Alto
Mayorga           ,50103,4086,49,26,23,5.838509316770186,Bajo-medio
Mayorga           ,50103,7158,42,23,19,4.968944099378882,Bajo-medio
Mayorga           ,50103,7216,109,53,56,13.291925465838508,Alto-medio
Mayorga           ,50103,8090,37,22,15,4.3478260869565215,Bajo-medio
Mayorga           ,50103,8562,35,17,18,4.099378881987578,Bajo-medio
Mayorga           ,50103,9725,12,7,5,1.2422360248447204,Bajo
Mayorga           ,50103,12113,35,22,13,4.099378881987578,Bajo-medio
Mayorga           ,50103,14575,88,42,46,10.683229813664596,Medio
Mayorga           ,50103,14985,51,22,29,6.086956521739131,Bajo-medio
Mayorga           ,50103,15427,42,19,23,4.968944099378882,Bajo-medio
Mayorga           ,50103,19061,18,10,8,1.9875776397515528,Bajo
Mayorga           ,50103,19102,75,36,39,9.06832298136646,Medio
Mayorga           ,50103,19598,25,8,17,2.857142857142857,Bajo-medio
Mayorga           ,50103,27055,56,31,25,6.70807453416149,Medio
Mayorga           ,50103,31332,50,23,27,5.962732919254658,Bajo-medio
Mayorga           ,50103,31988,75,41,34,9.06832298136646,Medio
Mayorga           ,50103,32169,51,17,34,6.086956521739131,Bajo-medio
Mayorga           ,50103,35640,116,63,53,14.161490683229813,Alto-medio
Mayorga           ,50103,35807,24,8,16,2.732919254658385,Bajo
Mayorga           ,50103,36630,83,41,42,10.062111801242237,Medio
Mayorga           ,50103,70754,74,30,44,8.944099378881988,Medio
Mayorga           ,50103,70755,94,40,54,11.428571428571429,Medio
Mayorga           ,50103,70756,173,86,87,21.242236024844722,Alto-medio
Mayorga           ,50103,70757,71,30,41,8.571428571428571,Medio
Mayorga           ,50103,70758,114,60,54,13.91304347826087,Alto-medio
Nacascolo         ,50104,3409,57,30,27,6.832298136645963,Medio
Nacascolo         ,50104,4562,9,5,4,0.8695652173913043,Bajo
Nacascolo         ,50104,4647,112,56,56,13.664596273291925,Alto-medio
Nacascolo         ,50104,5985,79,54,25,9.565217391304348,Medio
Nacascolo         ,50104,6671,178,87,91,21.86335403726708,Alto
Nacascolo         ,50104,7958,10,6,4,0.9937888198757764,Bajo
Nacascolo         ,50104,9205,208,117,91,25.59006211180124,Alto
Nacascolo         ,50104,11862,254,101,153,31.30434782608696,Alto
Nacascolo         ,50104,12914,126,57,69,15.403726708074533,Alto-medio
Nacascolo         ,50104,13008,39,24,15,4.596273291925466,Bajo-medio
Nacascolo         ,50104,15381,12,7,5,1.2422360248447204,Bajo
Nacascolo         ,50104,17560,160,74,86,19.627329192546583,Alto-medio
Nacascolo         ,50104,18909,157,73,84,19.25465838509317,Alto-medio
Nacascolo         ,50104,20792,18,11,7,1.9875776397515528,Bajo
Nacascolo         ,50104,21997,115,58,57,14.037267080745341,Alto-medio
Nacascolo         ,50104,23130,99,41,58,12.049689440993788,Medio
Nacascolo         ,50104,24723,52,28,24,6.211180124223603,Bajo-medio
Nacascolo         ,50104,25932,2,2,0,0.0,Bajo
Nacascolo         ,50104,28117,68,38,30,8.198757763975156,Medio
Nacascolo         ,50104,29907,85,40,45,10.31055900621118,Medio
Nacascolo         ,50104,32800,80,37,43,9.68944099378882,Medio
Nacascolo         ,50104,35203,13,6,7,1.3664596273291925,Bajo
Nacascolo         ,50104,35570,5,3,2,0.37267080745341613,Bajo
Nacascolo         ,50104,37589,11,6,5,1.1180124223602486,Bajo
Nacascolo         ,50104,37727,104,51,53,12.670807453416149,Alto-medio
Nacascolo         ,50104,37760,48,23,25,5.714285714285714,Bajo-medio
Nacascolo         ,50104,38279,68,34,34,8.198757763975156,Medio
Nacascolo         ,50104,70093,80,35,45,9.68944099378882,Medio
Curubandé         ,50105,1289,72,37,35,8.695652173913043,Medio
Curubandé         ,50105,2746,108,40,68,13.167701863354036,Alto-medio
Curubandé         ,50105,2846,13,8,5,1.3664596273291925,Bajo
Curubandé         ,50105,6459,155,79,76,19.006211180124225,Alto-medio
Curubandé         ,50105,7130,92,47,45,11.180124223602485,Medio
Curubandé         ,50105,8229,14,5,9,1.4906832298136645,Bajo
Curubandé         ,50105,8681,8,3,5,0.7453416149068323,Bajo
Curubandé         ,50105,13091,41,25,16,4.84472049689441,Bajo-medio
Curubandé         ,50105,14310,17,8,9,1.8633540372670807,Bajo
Curubandé         ,50105,15182,152,72,80,18.633540372670808,Alto-medio
Curubandé         ,50105,16760,67,33,34,8.074534161490684,Medio
Curubandé         ,50105,18122,62,28,34,7.453416149068323,Medio
Curubandé         ,50105,21568,32,13,19,3.7267080745341614,Bajo-medio
Curubandé         ,50105,22459,101,44,57,12.298136645962733,Alto-medio
Curubandé         ,50105,22579,15,8,7,1.6149068322981366,Bajo
Curubandé         ,50105,22923,24,12,12,2.732919254658385,Bajo
Curubandé         ,50105,23571,114,55,59,13.91304347826087,Alto-medio
Curubandé         ,50105,23723,23,12,11,2.608695652173913,Bajo
Curubandé         ,50105,26080,27,15,12,3.1055900621118013,Bajo-medio
Curubandé         ,50105,26791,68,33,35,8.198757763975156,Medio
Curubandé         ,50105,30879,179,86,93,21.987577639751553,Alto
Curubandé         ,50105,35941,19,12,7,2.111801242236025,Bajo
Curubandé         ,50105,70094,221,107,114,27.204968944099377,Alto
Curubandé         ,50105,70095,49,24,25,5.838509316770186,Bajo-medio
Curubandé         ,50105,70096,48,28,20,5.714285714285714,Bajo-medio
Curubandé         ,50105,70097,177,84,93,21.73913043478261,Alto
Curubandé         ,50105,70098,212,110,102,26.08695652173913,Alto
Curubandé         ,50105,70099,47,22,25,5.590062111801243,Bajo-medio
Curubandé         ,50105,70100,107,55,52,13.043478260869565,Alto-medio
Curubandé         ,50105,70101,54,28,26,6.459627329192546,Medio
Curubandé         ,50105,70102,76,35,41,9.192546583850932,Medio
Curubandé         ,50105,72849,133,60,73,16.273291925465838,Alto-medio
